C 15000

CE <078>
CR <178>
CP <138>

F 8

I 1

L * # # + # | + + # + - + + + + + x


R {    1} {0} {<130>} {exit} { } {} {} {}
E {    2} {s} {s} {4} {0}

R {    2} {0} {} {2} { } {} {} {}
E {    1} {n} {n} {1} {0}
E {    3} {w} {w} {8} {0}
E {   63} {e} {e} {2} {0}

R {    3} {0} {} {3} { } {} {} {}
E {    2} {e} {e} {2} {0}
E {    4} {w} {w} {8} {0}

R {    4} {0} {} {4} { } {} {} {}
E {    3} {e} {e} {2} {0}
E {    5} {w} {w} {8} {0}

R {    5} {0} {} {5} { } {} {} {}
E {    4} {e} {e} {2} {0}
E {    6} {n} {n} {1} {0}
E {   10} {w} {w} {8} {0}
E {   62} {s} {s} {4} {0}

R {    6} {0} {} {6} { } {} {} {}
E {    5} {s} {s} {4} {0}
E {    7} {w} {w} {8} {0}

R {    7} {0} {} {7} { } {} {} {}
E {    6} {e} {e} {2} {0}
E {    8} {w} {w} {8} {0}
E {   10} {s} {s} {4} {0}

R {    8} {0} {} {8} { } {} {} {}
E {    7} {e} {e} {2} {0}
E {    9} {s} {s} {4} {0}
E {   11} {n} {n} {1} {0}

R {    9} {0} {} {9} { } {} {} {}
E {    8} {n} {n} {1} {0}
E {   10} {e} {e} {2} {0}
E {   14} {w} {w} {8} {0}
E {   60} {s} {s} {4} {0}

R {   10} {0} {} {10} { } {} {} {}
E {    9} {w} {w} {8} {0}
E {    7} {n} {n} {1} {0}
E {    5} {e} {e} {2} {0}
E {   61} {s} {s} {4} {0}

R {   11} {0} {} {11} { } {} {} {}
E {    8} {s} {s} {4} {0}
E {   12} {w} {w} {8} {0}

R {   12} {0} {} {12} { } {} {} {}
E {   11} {e} {e} {2} {0}
E {   13} {s} {s} {4} {0}

R {   13} {0} {} {13} { } {} {} {}
E {   12} {n} {n} {1} {0}
E {   14} {s} {s} {4} {0}

R {   14} {0} {} {14} { } {} {} {}
E {   13} {n} {n} {1} {0}
E {    9} {e} {e} {2} {0}
E {   15} {w} {w} {8} {0}
E {   57} {s} {s} {4} {0}

R {   15} {0} {} {15} { } {} {} {}
E {   14} {e} {e} {2} {0}
E {   16} {w} {w} {8} {0}

R {   16} {0} {} {16} { } {} {} {}
E {   15} {e} {e} {2} {0}
E {   17} {n} {n} {1} {0}
E {   36} {s} {s} {4} {0}

R {   17} {0} {} {17} { } {} {} {}
E {   16} {s} {s} {4} {0}
E {   18} {n} {n} {1} {0}

R {   18} {0} {} {18} { } {} {} {}
E {   17} {s} {s} {4} {0}
E {   19} {n} {n} {1} {0}

R {   19} {0} {} {19} { } {} {} {}
E {   18} {s} {s} {4} {0}
E {   20} {w} {w} {8} {0}

R {   20} {0} {} {20} { } {} {} {}
E {   19} {e} {e} {2} {0}
E {   21} {n} {n} {1} {0}

R {   21} {0} {} {21} { } {} {} {}
E {   20} {s} {s} {4} {0}
E {   22} {w} {w} {8} {0}
E {   23} {n} {n} {1} {0}

R {   22} {0} {} {22} { } {} {} {}
E {   21} {e} {e} {2} {0}
E {   24} {n} {n} {1} {0}

R {   23} {0} {} {23} { } {} {} {}
E {   21} {s} {s} {4} {0}
E {   24} {w} {w} {8} {0}
E {   26} {e} {e} {2} {0}

R {   24} {0} {} {24} { } {} {} {}
E {   23} {e} {e} {2} {0}
E {   22} {s} {s} {4} {0}
E {   25} {w} {w} {8} {0}

R {   25} {0} {} {25} { } {} {} {}
E {   24} {e} {e} {2} {0}

R {   26} {0} {} {26} { } {} {} {}
E {   23} {w} {w} {8} {0}
E {   27} {e} {e} {2} {0}

R {   27} {0} {} {27} { } {} {} {}
E {   26} {w} {w} {8} {0}
E {   28} {s} {s} {4} {0}
E {   30} {e} {e} {2} {0}

R {   28} {0} {} {28} { } {} {} {}
E {   27} {n} {n} {1} {0}
E {   29} {s} {s} {4} {0}

R {   29} {0} {} {29} { } {} {} {}
E {   28} {n} {n} {1} {0}

R {   30} {0} {} {30} { } {} {} {}
E {   27} {w} {w} {8} {0}
E {   31} {e} {e} {2} {0}

R {   31} {0} {} {31} { } {} {} {}
E {   30} {w} {w} {8} {0}
E {   32} {s} {s} {4} {0}
E {   35} {e} {e} {2} {0}

R {   32} {0} {} {32} { } {} {} {}
E {   31} {n} {n} {1} {0}
E {   33} {w} {w} {8} {0}
E {   34} {e} {e} {2} {0}

R {   33} {0} {} {33} { } {} {} {}
E {   32} {e} {e} {2} {0}

R {   34} {0} {} {34} { } {} {} {}
E {   32} {w} {w} {8} {0}
E {   35} {n} {n} {1} {0}

R {   35} {0} {} {35} { } {} {} {}
E {   34} {s} {s} {4} {0}
E {   31} {w} {w} {8} {0}

R {   36} {0} {} {36} { } {} {} {}
E {   16} {n} {n} {1} {0}
E {   37} {s} {s} {4} {0}

R {   37} {0} {} {37} { } {} {} {}
E {   36} {n} {n} {1} {0}
E {   38} {s} {s} {4} {0}

R {   38} {0} {} {38} { } {} {} {}
E {   37} {n} {n} {1} {0}
E {   39} {w} {w} {8} {0}
E {   56} {e} {e} {2} {0}

R {   39} {0} {} {39} { } {} {} {}
E {   38} {e} {e} {2} {0}
E {   40} {s} {s} {4} {0}

R {   40} {0} {} {40} { } {} {} {}
E {   39} {n} {n} {1} {0}
E {   41} {w} {w} {8} {0}

R {   41} {0} {} {41} { } {} {} {}
E {   40} {e} {e} {2} {0}
E {   42} {w} {w} {8} {0}

R {   42} {0} {} {42} { } {} {} {}
E {   41} {e} {e} {2} {0}
E {   43} {s} {s} {4} {0}

R {   43} {0} {} {43} { } {} {} {}
E {   42} {n} {n} {1} {0}
E {   44} {e} {e} {2} {0}

R {   44} {0} {} {44} { } {} {} {}
E {   43} {w} {w} {8} {0}
E {   45} {e} {e} {2} {0}

R {   45} {0} {} {45} { } {} {} {}
E {   44} {w} {w} {8} {0}
E {   46} {e} {e} {2} {0}

R {   46} {0} {} {46} { } {} {} {}
E {   45} {w} {w} {8} {0}
E {   47} {e} {e} {2} {0}

R {   47} {0} {} {47} { } {} {} {}
E {   46} {w} {w} {8} {0}
E {   48} {e} {e} {2} {0}

R {   48} {0} {} {48} { } {} {} {}
E {   47} {w} {w} {8} {0}
E {   49} {n} {n} {1} {0}
E {   50} {e} {e} {2} {0}

R {   49} {0} {} {49} { } {} {} {}
E {   48} {s} {s} {4} {0}
E {   51} {e} {e} {2} {0}
E {   54} {w} {w} {8} {0}

R {   50} {0} {} {50} { } {} {} {}
E {   48} {w} {w} {8} {0}
E {   51} {n} {n} {1} {0}

R {   51} {0} {} {51} { } {} {} {}
E {   50} {s} {s} {4} {0}
E {   49} {w} {w} {8} {0}
E {   52} {e} {e} {2} {0}

R {   52} {0} {} {52} { } {} {} {}
E {   51} {w} {w} {8} {0}
E {   53} {s} {s} {4} {0}

R {   53} {0} {} {53} { } {} {} {}
E {   52} {n} {n} {1} {0}

R {   54} {0} {} {54} { } {} {} {}
E {   49} {e} {e} {2} {0}
E {   55} {w} {w} {8} {0}
E {   56} {n} {n} {1} {0}

R {   55} {0} {} {55} { } {} {} {}
E {   54} {e} {e} {2} {0}

R {   56} {0} {} {56} { } {} {} {}
E {   54} {s} {s} {4} {0}
E {   38} {w} {w} {8} {0}

R {   57} {0} {} {57} { } {} {} {}
E {   14} {n} {n} {1} {0}
E {   58} {s} {s} {4} {0}
E {   60} {e} {e} {2} {0}

R {   58} {0} {} {58} { } {} {} {}
E {   57} {n} {n} {1} {0}
E {   59} {e} {e} {2} {0}

R {   59} {0} {} {59} { } {} {} {}
E {   58} {w} {w} {8} {0}
E {   60} {n} {n} {1} {0}

R {   60} {0} {} {60} { } {} {} {}
E {   59} {s} {s} {4} {0}
E {   57} {w} {w} {8} {0}
E {    9} {n} {n} {1} {0}
E {   61} {e} {e} {2} {0}

R {   61} {0} {} {61} { } {} {} {}
E {   10} {n} {n} {1} {0}
E {   60} {w} {w} {8} {0}
E {   62} {e} {e} {2} {0}

R {   62} {0} {} {62} { } {} {} {}
E {   61} {w} {w} {8} {0}
E {    5} {n} {n} {1} {0}

R {   63} {0} {} {63} { } {} {} {}
E {    2} {w} {w} {8} {0}
E {   64} {e} {e} {2} {0}

R {   64} {0} {} {64} { } {} {} {}
E {   63} {w} {w} {8} {0}
E {   65} {n} {n} {1} {0}
E {   69} {e} {e} {2} {0}
E {   71} {s} {s} {4} {0}

R {   65} {0} {} {65} { } {} {} {}
E {   64} {s} {s} {4} {0}
E {   66} {n} {n} {1} {0}

R {   66} {0} {} {66} { } {} {} {}
E {   65} {s} {s} {4} {0}
E {   67} {n} {n} {1} {0}

R {   67} {0} {} {67} { } {} {} {}
E {   66} {s} {s} {4} {0}
E {   68} {n} {n} {1} {0}

R {   68} {0} {<120>} {pub} { } {} {} {}
E {   67} {s} {s} {4} {0}

R {   69} {0} {} {69} { } {} {} {}
E {   64} {w} {w} {8} {0}
E {   70} {n} {n} {1} {0}
E {   75} {e} {e} {2} {0}

R {   70} {0} {<120>} {shop} { } {} {} {}
E {   69} {s} {s} {4} {0}

R {   71} {0} {} {71} { } {} {} {}
E {   64} {n} {n} {1} {0}
E {   72} {e} {e} {2} {0}
E {   73} {s} {s} {4} {0}

R {   72} {0} {} {72} { } {} {} {}
E {   71} {w} {w} {8} {0}

R {   73} {0} {} {73} { } {} {} {}
E {   71} {n} {n} {1} {0}
E {   74} {e} {e} {2} {0}

R {   74} {0} {} {74} { } {} {} {}
E {   73} {w} {w} {8} {0}

R {   75} {0} {} {75} { } {} {} {}
E {   69} {w} {w} {8} {0}
E {   76} {e} {e} {2} {0}

R {   76} {0} {} {76} { } {} {} {}
E {   75} {w} {w} {8} {0}
