C 15000

CE <078>
CR <178>

F 8

I 1

L * # # + # | + + # + - + + + + + x


R {    1} {0} {} {exit} { } {} {} {}
E {    2} {s} {s} {4}

R {    2} {0} {} {2} { } {} {} {}
E {    1} {n} {n} {1}
E {    3} {w} {w} {8}
E {    5} {s} {s} {4}

R {    3} {0} {} {3} { } {} {} {}
E {    2} {e} {e} {2}
E {    4} {s} {s} {4}
E {    6} {w} {w} {8}
E {   12} {q} {q} {9}

R {    4} {0} {} {4} { } {} {} {}
E {    3} {n} {n} {1}
E {    5} {e} {e} {2}
E {    6} {q} {q} {9}

R {    5} {0} {} {5} { } {} {} {}
E {    2} {n} {n} {1}
E {    4} {w} {w} {8}

R {    6} {0} {} {6} { } {} {} {}
E {    4} {v} {v} {6}
E {    3} {e} {e} {2}
E {    7} {w} {w} {8}
E {   12} {n} {n} {1}

R {    7} {0} {} {7} { } {} {} {}
E {    6} {e} {e} {2}
E {    8} {z} {z} {12}
E {    9} {w} {w} {8}
E {   11} {n} {n} {1}
E {   10} {q} {q} {9}

R {    8} {0} {} {8} { } {} {} {}
E {    7} {r} {r} {3}
E {    9} {n} {n} {1}

R {    9} {0} {} {9} { } {} {} {}
E {    8} {s} {s} {4}
E {    7} {e} {e} {2}
E {   10} {n} {n} {1}

R {   10} {0} {} {10} { } {} {} {}
E {    9} {s} {s} {4}
E {   11} {e} {e} {2}
E {    7} {v} {v} {6}
E {   15} {n} {n} {1}

R {   11} {0} {} {11} { } {} {} {}
E {   10} {w} {w} {8}
E {    7} {s} {s} {4}
E {   12} {e} {e} {2}
E {   14} {r} {r} {3}
E {   15} {q} {q} {9}

R {   12} {0} {} {12} { } {} {} {}
E {   11} {w} {w} {8}
E {    6} {s} {s} {4}
E {    3} {v} {v} {6}
E {   13} {r} {r} {3}
E {   14} {n} {n} {1}

R {   13} {0} {} {13} { } {} {} {}
E {   12} {z} {z} {12}
E {   14} {w} {w} {8}
E {   16} {n} {n} {1}
E {   17} {q} {q} {9}

R {   14} {0} {} {14} { } {} {} {}
E {   13} {e} {e} {2}
E {   12} {s} {s} {4}
E {   11} {z} {z} {12}
E {   17} {n} {n} {1}
E {   18} {q} {q} {9}

R {   15} {0} {} {15} { } {} {} {}
E {   11} {v} {v} {6}
E {   10} {s} {s} {4}

R {   16} {0} {} {16} { } {} {} {}
E {   13} {s} {s} {4}
E {   17} {w} {w} {8}
E {   29} {q} {q} {9}

R {   17} {0} {} {17} { } {} {} {}
E {   16} {e} {e} {2}
E {   14} {s} {s} {4}
E {   13} {v} {v} {6}
E {   18} {w} {w} {8}
E {   29} {n} {n} {1}

R {   18} {0} {} {18} { } {} {} {}
E {   17} {e} {e} {2}
E {   14} {v} {v} {6}
E {   19} {w} {w} {8}
E {   26} {n} {n} {1}

R {   19} {0} {} {19} { } {} {} {}
E {   18} {e} {e} {2}
E {   20} {z} {z} {12}
E {   26} {r} {r} {3}

R {   20} {0} {} {20} { } {} {} {}
E {   19} {r} {r} {3}
E {   21} {q} {q} {9}

R {   21} {0} {} {21} { } {} {} {}
E {   20} {v} {v} {6}
E {   22} {q} {q} {9}
E {   23} {n} {n} {1}

R {   22} {0} {} {22} { } {} {} {}
E {   21} {v} {v} {6}
E {   23} {e} {e} {2}
E {   24} {r} {r} {3}
E {   31} {n} {n} {1}

R {   23} {0} {} {23} { } {} {} {}
E {   22} {w} {w} {8}
E {   21} {s} {s} {4}
E {   24} {n} {n} {1}
E {   25} {r} {r} {3}

R {   24} {0} {} {24} { } {} {} {}
E {   23} {s} {s} {4}
E {   25} {e} {e} {2}
E {   22} {z} {z} {12}

R {   25} {0} {} {25} { } {} {} {}
E {   24} {w} {w} {8}
E {   23} {z} {z} {12}

R {   26} {0} {} {26} { } {} {} {}
E {   19} {z} {z} {12}
E {   18} {s} {s} {4}
E {   27} {q} {q} {9}
E {   28} {n} {n} {1}
E {   29} {e} {e} {2}

R {   27} {0} {} {27} { } {} {} {}
E {   26} {v} {v} {6}
E {   28} {e} {e} {2}

R {   28} {0} {} {28} { } {} {} {}
E {   27} {w} {w} {8}
E {   26} {s} {s} {4}
E {   30} {e} {e} {2}

R {   29} {0} {} {29} { } {} {} {}
E {   26} {w} {w} {8}
E {   30} {n} {n} {1}
E {   16} {v} {v} {6}
E {   17} {s} {s} {4}

R {   30} {0} {} {30} { } {} {} {}
E {   29} {s} {s} {4}
E {   28} {w} {w} {8}

R {   31} {0} {} {31} { } {} {} {}
E {   22} {s} {s} {4}
E {   32} {w} {w} {8}

R {   32} {0} {} {32} { } {} {} {}
E {   31} {e} {e} {2}
