C 15000

CE <078>
CR <178>
CP <138>

F 8

I 49

L * # # + # | + + # + - + + + + + x


R {    1} {0} {<130>} {1} { } {} {} {}
E {    2} {s} {s} {4} {0}

R {    2} {0} {} {2} { } {} {} {}
E {    1} {n} {n} {1} {0}
E {    3} {e} {e} {2} {0}
E {    5} {s} {s} {4} {0}

R {    3} {0} {} {3} { } {} {} {}
E {    2} {w} {w} {8} {0}
E {    4} {s} {s} {4} {0}

R {    4} {0} {} {4} { } {} {} {}
E {    3} {n} {n} {1} {0}
E {    5} {w} {w} {8} {0}
E {   15} {e} {e} {2} {0}
E {   17} {s} {s} {4} {0}

R {    5} {0} {} {5} { } {} {} {}
E {    4} {e} {e} {2} {0}
E {    2} {n} {n} {1} {0}
E {    6} {w} {w} {8} {0}
E {    8} {s} {s} {4} {0}

R {    6} {0} {} {6} { } {} {} {}
E {    5} {e} {e} {2} {0}
E {    7} {s} {s} {4} {0}

R {    7} {0} {} {7} { } {} {} {}
E {    6} {n} {n} {1} {0}
E {    8} {e} {e} {2} {0}
E {   10} {s} {s} {4} {0}

R {    8} {0} {} {8} { } {} {} {}
E {    7} {w} {w} {8} {0}
E {    5} {n} {n} {1} {0}
E {    9} {s} {s} {4} {0}
E {   17} {e} {e} {2} {0}

R {    9} {0} {} {9} { } {} {} {}
E {    8} {n} {n} {1} {0}
E {   10} {w} {w} {8} {0}
E {   12} {s} {s} {4} {0}
E {   20} {e} {e} {2} {0}

R {   10} {0} {} {10} { } {} {} {}
E {    9} {e} {e} {2} {0}
E {    7} {n} {n} {1} {0}
E {   11} {s} {s} {4} {0}

R {   11} {0} {} {11} { } {} {} {}
E {   10} {n} {n} {1} {0}
E {   12} {e} {e} {2} {0}

R {   12} {0} {} {12} { } {} {} {}
E {   11} {w} {w} {8} {0}
E {    9} {n} {n} {1} {0}
E {   13} {s} {s} {4} {0}
E {   21} {e} {e} {2} {0}

R {   13} {0} {} {13} { } {} {} {}
E {   12} {n} {n} {1} {0}
E {   14} {s} {s} {4} {0}
E {   22} {e} {e} {2} {0}

R {   14} {0} {} {14} { } {} {} {}
E {   13} {n} {n} {1} {0}
E {   23} {e} {e} {2} {0}

R {   15} {0} {} {15} { } {} {} {}
E {    4} {w} {w} {8} {0}
E {   16} {s} {s} {4} {0}

R {   16} {0} {} {16} { } {} {} {}
E {   15} {n} {n} {1} {0}
E {   17} {w} {w} {8} {0}
E {   18} {s} {s} {4} {0}

R {   17} {0} {} {17} { } {} {} {}
E {   16} {e} {e} {2} {0}
E {    4} {n} {n} {1} {0}
E {    8} {w} {w} {8} {0}
E {   20} {s} {s} {4} {0}

R {   18} {0} {} {18} { } {} {} {}
E {   16} {n} {n} {1} {0}
E {   19} {e} {e} {2} {0}
E {   20} {w} {w} {8} {0}
E {   30} {s} {s} {4} {0}

R {   19} {0} {} {19} { } {} {} {}
E {   18} {w} {w} {8} {0}
E {   31} {s} {s} {4} {0}
E {   38} {e} {e} {2} {0}

R {   20} {0} {} {20} { } {} {} {}
E {   18} {e} {e} {2} {0}
E {   17} {n} {n} {1} {0}
E {    9} {w} {w} {8} {0}
E {   21} {s} {s} {4} {0}

R {   21} {0} {} {21} { } {} {} {}
E {   20} {n} {n} {1} {0}
E {   12} {w} {w} {8} {0}
E {   22} {s} {s} {4} {0}
E {   30} {e} {e} {2} {0}

R {   22} {0} {} {22} { } {} {} {}
E {   21} {n} {n} {1} {0}
E {   13} {w} {w} {8} {0}
E {   23} {s} {s} {4} {0}
E {   29} {e} {e} {2} {0}

R {   23} {0} {} {23} { } {} {} {}
E {   22} {n} {n} {1} {0}
E {   14} {w} {w} {8} {0}
E {   24} {s} {s} {4} {0}
E {   28} {e} {e} {2} {0}

R {   24} {0} {} {24} { } {} {} {}
E {   23} {n} {n} {1} {0}
E {   25} {e} {e} {2} {0}

R {   25} {0} {} {25} { } {} {} {}
E {   24} {w} {w} {8} {0}
E {   26} {e} {e} {2} {0}
E {   28} {n} {n} {1} {0}

R {   26} {0} {} {26} { } {} {} {}
E {   25} {w} {w} {8} {0}
E {   27} {n} {n} {1} {0}

R {   27} {0} {} {27} { } {} {} {}
E {   26} {s} {s} {4} {0}
E {   28} {w} {w} {8} {0}
E {   32} {n} {n} {1} {0}
E {   33} {e} {e} {2} {0}

R {   28} {0} {} {28} { } {} {} {}
E {   27} {e} {e} {2} {0}
E {   25} {s} {s} {4} {0}
E {   23} {w} {w} {8} {0}
E {   29} {n} {n} {1} {0}

R {   29} {0} {} {29} { } {} {} {}
E {   28} {s} {s} {4} {0}
E {   22} {w} {w} {8} {0}
E {   30} {n} {n} {1} {0}
E {   32} {e} {e} {2} {0}

R {   30} {0} {} {30} { } {} {} {}
E {   29} {s} {s} {4} {0}
E {   21} {w} {w} {8} {0}
E {   18} {n} {n} {1} {0}
E {   31} {e} {e} {2} {0}

R {   31} {0} {} {31} { } {} {} {}
E {   19} {n} {n} {1} {0}
E {   30} {w} {w} {8} {0}
E {   32} {s} {s} {4} {0}
E {   37} {e} {e} {2} {0}

R {   32} {0} {} {32} { } {} {} {}
E {   31} {n} {n} {1} {0}
E {   29} {w} {w} {8} {0}
E {   27} {s} {s} {4} {0}
E {   36} {e} {e} {2} {0}

R {   33} {0} {} {33} { } {} {} {}
E {   27} {w} {w} {8} {0}
E {   34} {e} {e} {2} {0}
E {   36} {n} {n} {1} {0}

R {   34} {0} {<110>} {tangerine} { } {} {} {}
E {   33} {w} {w} {8} {0}
E {   35} {n} {n} {1} {0}

R {   35} {0} {} {35} { } {} {} {}
E {   34} {s} {s} {4} {0}
E {   36} {w} {w} {8} {0}
E {   40} {n} {n} {1} {0}
E {   41} {e} {e} {2} {0}

R {   36} {0} {} {36} { } {} {} {}
E {   35} {e} {e} {2} {0}
E {   33} {s} {s} {4} {0}
E {   32} {w} {w} {8} {0}
E {   37} {n} {n} {1} {0}

R {   37} {0} {} {37} { } {} {} {}
E {   36} {s} {s} {4} {0}
E {   38} {n} {n} {1} {0}
E {   31} {w} {w} {8} {0}
E {   40} {e} {e} {2} {0}

R {   38} {0} {} {38} { } {} {} {}
E {   37} {s} {s} {4} {0}
E {   19} {w} {w} {8} {0}
E {   39} {e} {e} {2} {0}

R {   39} {0} {} {39} { } {} {} {}
E {   38} {w} {w} {8} {0}
E {   40} {s} {s} {4} {0}
E {   43} {e} {e} {2} {0}

R {   40} {0} {} {40} { } {} {} {}
E {   39} {n} {n} {1} {0}
E {   37} {w} {w} {8} {0}
E {   35} {s} {s} {4} {0}
E {   42} {e} {e} {2} {0}

R {   41} {0} {} {41} { } {} {} {}
E {   35} {w} {w} {8} {0}
E {   42} {n} {n} {1} {0}

R {   42} {0} {} {42} { } {} {} {}
E {   41} {s} {s} {4} {0}
E {   40} {w} {w} {8} {0}
E {   43} {n} {n} {1} {0}
E {   45} {e} {e} {2} {0}

R {   43} {0} {} {43} { } {} {} {}
E {   39} {w} {w} {8} {0}
E {   42} {s} {s} {4} {0}
E {   44} {e} {e} {2} {0}

R {   44} {0} {} {44} { } {} {} {}
E {   43} {w} {w} {8} {0}
E {   45} {s} {s} {4} {0}
E {   46} {e} {e} {2} {0}

R {   45} {0} {} {45} { } {} {} {}
E {   44} {n} {n} {1} {0}
E {   42} {w} {w} {8} {0}
E {   47} {e} {e} {2} {0}

R {   46} {0} {} {46} { } {} {} {}
E {   44} {w} {w} {8} {0}
E {   47} {s} {s} {4} {0}
E {   48} {e} {e} {2} {0}

R {   47} {0} {} {47} { } {} {} {}
E {   46} {n} {n} {1} {0}
E {   45} {w} {w} {8} {0}

R {   48} {0} {} {48} { } {} {} {}
E {   46} {w} {w} {8} {0}
E {   49} {e} {e} {2} {0}

R {   49} {0} {<120>} {exit} { } {} {} {}
E {   48} {w} {w} {8} {0}
